%BASISPACKAGEPREFIX-%LANGUAGESTRING	Language module for %PRODUCTNAME %PRODUCTVERSION, language %LANGUAGESTRING
%BASISPACKAGEPREFIX-%LANGUAGESTRING-base	Base language module for %PRODUCTNAME %PRODUCTVERSION, language %LANGUAGESTRING
%BASISPACKAGEPREFIX-%LANGUAGESTRING-calc	Calc language module for %PRODUCTNAME %PRODUCTVERSION, language %LANGUAGESTRING
%BASISPACKAGEPREFIX-%LANGUAGESTRING-draw	Draw language module for %PRODUCTNAME %PRODUCTVERSION, language %LANGUAGESTRING
%BASISPACKAGEPREFIX-%LANGUAGESTRING-fonts	Language fonts module for %PRODUCTNAME %PRODUCTVERSION, language %LANGUAGESTRING
%BASISPACKAGEPREFIX-%LANGUAGESTRING-help	Language help module for %PRODUCTNAME %PRODUCTVERSION, language %LANGUAGESTRING
%BASISPACKAGEPREFIX-%LANGUAGESTRING-impress	Impress language module for %PRODUCTNAME %PRODUCTVERSION, language %LANGUAGESTRING
%BASISPACKAGEPREFIX-%LANGUAGESTRING-math	Math language module for %PRODUCTNAME %PRODUCTVERSION, language %LANGUAGESTRING
%BASISPACKAGEPREFIX-%LANGUAGESTRING-onlineupd	Online update language module for %PRODUCTNAME %PRODUCTVERSION, language %LANGUAGESTRING
%BASISPACKAGEPREFIX-%LANGUAGESTRING-res	Language resource module for %PRODUCTNAME %PRODUCTVERSION, language %LANGUAGESTRING
%BASISPACKAGEPREFIX-%LANGUAGESTRING-writer	Writer language module for %PRODUCTNAME %PRODUCTVERSION, language %LANGUAGESTRING
%BASISPACKAGEPREFIX-activex	ActiveX control for %PRODUCTNAME %PRODUCTVERSION
%BASISPACKAGEPREFIX-base	Base module for %PRODUCTNAME %PRODUCTVERSION
%BASISPACKAGEPREFIX-calc	Calc module for %PRODUCTNAME %PRODUCTVERSION
%BASISPACKAGEPREFIX-core	Core module for %PRODUCTNAME %PRODUCTVERSION
%BASISPACKAGEPREFIX-dict-gl	Gl dictionary for %PRODUCTNAME %PRODUCTVERSION
%BASISPACKAGEPREFIX-dict-vi	Vietnamese dictionary for %PRODUCTNAME %PRODUCTVERSION
%BASISPACKAGEPREFIX-draw	Draw module for %PRODUCTNAME %PRODUCTVERSION
%BASISPACKAGEPREFIX-emailmerge	Email mailmerge module for %PRODUCTNAME %PRODUCTVERSION
%BASISPACKAGEPREFIX-gnome-integratn	GNOME integration module for %PRODUCTNAME %PRODUCTVERSION
%BASISPACKAGEPREFIX-graphicfilter	Graphic filter module for %PRODUCTNAME %PRODUCTVERSION
%BASISPACKAGEPREFIX-headless	Headless display module for %PRODUCTNAME %PRODUCTVERSION
%BASISPACKAGEPREFIX-images	Images module for %PRODUCTNAME %PRODUCTVERSION
%BASISPACKAGEPREFIX-impress	Impress module for %PRODUCTNAME %PRODUCTVERSION
%BASISPACKAGEPREFIX-kde-integration	KDE integration module for %PRODUCTNAME %PRODUCTVERSION
%BASISPACKAGEPREFIX-math	Math module for %PRODUCTNAME %PRODUCTVERSION
%BASISPACKAGEPREFIX-onlineupdate	Online update module for %PRODUCTNAME %PRODUCTVERSION
%BASISPACKAGEPREFIX-ooofonts	3rd party free fonts for %PRODUCTNAME %PRODUCTVERSION
%BASISPACKAGEPREFIX-ooolinguistic	Linguistic module for %PRODUCTNAME %PRODUCTVERSION
%BASISPACKAGEPREFIX-pyuno	Pyuno module for %PRODUCTNAME %PRODUCTVERSION
%BASISPACKAGEPREFIX-spellcheck	English spellchecker module for %PRODUCTNAME %PRODUCTVERSION
%BASISPACKAGEPREFIX-testtool	Testtool module for %PRODUCTNAME %PRODUCTVERSION
%BASISPACKAGEPREFIX-writer	Writer module for %PRODUCTNAME %PRODUCTVERSION
%BASISPACKAGEPREFIX-xsltfilter	XSLT filter samples module for %PRODUCTNAME %PRODUCTVERSION
%PACKAGEPREFIX%SOLARISBRANDPACKAGENAME-dict-af	Af dictionary for %PRODUCTNAME %PRODUCTVERSION
%PACKAGEPREFIX%SOLARISBRANDPACKAGENAME-dict-cs	Cs dictionary for %PRODUCTNAME %PRODUCTVERSION
%PACKAGEPREFIX%SOLARISBRANDPACKAGENAME-dict-da	Da dictionary for %PRODUCTNAME %PRODUCTVERSION
%PACKAGEPREFIX%SOLARISBRANDPACKAGENAME-dict-de	De dictionary for %PRODUCTNAME %PRODUCTVERSION
%PACKAGEPREFIX%SOLARISBRANDPACKAGENAME-dict-en	En dictionary for %PRODUCTNAME %PRODUCTVERSION
%PACKAGEPREFIX%SOLARISBRANDPACKAGENAME-dict-es	Es dictionary for %PRODUCTNAME %PRODUCTVERSION
%PACKAGEPREFIX%SOLARISBRANDPACKAGENAME-dict-et	Et dictionary for %PRODUCTNAME %PRODUCTVERSION
%PACKAGEPREFIX%SOLARISBRANDPACKAGENAME-dict-fr	Fr dictionary for %PRODUCTNAME %PRODUCTVERSION
%PACKAGEPREFIX%SOLARISBRANDPACKAGENAME-dict-hu	Hu dictionary for %PRODUCTNAME %PRODUCTVERSION
%PACKAGEPREFIX%SOLARISBRANDPACKAGENAME-dict-hr	Hr dictionary for %PRODUCTNAME %PRODUCTVERSION
%PACKAGEPREFIX%SOLARISBRANDPACKAGENAME-dict-it	It dictionary for %PRODUCTNAME %PRODUCTVERSION
%PACKAGEPREFIX%SOLARISBRANDPACKAGENAME-dict-lt	Lt dictionary for %PRODUCTNAME %PRODUCTVERSION
%PACKAGEPREFIX%SOLARISBRANDPACKAGENAME-dict-ne	Ne dictionary for %PRODUCTNAME %PRODUCTVERSION
%PACKAGEPREFIX%SOLARISBRANDPACKAGENAME-dict-nl	Nl dictionary for %PRODUCTNAME %PRODUCTVERSION
%PACKAGEPREFIX%SOLARISBRANDPACKAGENAME-dict-pl	Pl dictionary for %PRODUCTNAME %PRODUCTVERSION
%PACKAGEPREFIX%SOLARISBRANDPACKAGENAME-dict-pt	Pt dictionary for %PRODUCTNAME %PRODUCTVERSION
%PACKAGEPREFIX%SOLARISBRANDPACKAGENAME-dict-ru	Ru dictionary for %PRODUCTNAME %PRODUCTVERSION
%PACKAGEPREFIX%SOLARISBRANDPACKAGENAME-dict-sk	Sk dictionary for %PRODUCTNAME %PRODUCTVERSION
%PACKAGEPREFIX%SOLARISBRANDPACKAGENAME-dict-sl	Sl dictionary for %PRODUCTNAME %PRODUCTVERSION
%PACKAGEPREFIX%SOLARISBRANDPACKAGENAME-dict-sv	Sv dictionary for %PRODUCTNAME %PRODUCTVERSION
%PACKAGEPREFIX%SOLARISBRANDPACKAGENAME-dict-sw	Sw dictionary for %PRODUCTNAME %PRODUCTVERSION
%PACKAGEPREFIX%SOLARISBRANDPACKAGENAME-dict-th	Th dictionary for %PRODUCTNAME %PRODUCTVERSION
%PACKAGEPREFIX%SOLARISBRANDPACKAGENAME-dict-zu	Zu dictionary for %PRODUCTNAME %PRODUCTVERSION
%WITHOUTDOTUNIXPACKAGENAME	Brand module for %PRODUCTNAME %PRODUCTVERSION
%WITHOUTDOTUNIXPACKAGENAME-%LANGUAGESTRING	Brand language module for %PRODUCTNAME %PRODUCTVERSION
%WITHOUTDOTUNIXPACKAGENAME-base	Base brand module for %PRODUCTNAME %PRODUCTVERSION
%WITHOUTDOTUNIXPACKAGENAME-calc	Calc brand module for %PRODUCTNAME %PRODUCTVERSION
%WITHOUTDOTUNIXPACKAGENAME-draw	Draw brand module for %PRODUCTNAME %PRODUCTVERSION
%WITHOUTDOTUNIXPACKAGENAME-impress	Impress brand module for %PRODUCTNAME %PRODUCTVERSION
%WITHOUTDOTUNIXPACKAGENAME-math	Math brand module for %PRODUCTNAME %PRODUCTVERSION
%WITHOUTDOTUNIXPACKAGENAME-writer	Writer brand module for %PRODUCTNAME %PRODUCTVERSION
